11111111111111111111
10000000000000000001
100P0000000000000001
10000000000000000001
10000000000000000001
1000000C000000000001
10000000000000000001
10000000000000000001
10000000000000000001
10000000000000000001
10000000000E00000001
11111111111111111111

