1111111111111111111111
1111011111111111111101
1PCCPP1111111111111111
1110000000000000000001
1000001111111111111111
1111111000000000000001
1111111111E00111111111
1111111111111111111111
